You can use it in your post by calling shortcode. [eth_price coin="ETN" usd="1" eur="1"] put 0 instead of 1 to disable pricing for that currency. Write the coin short code and done.
Total 3098 coins supported.
See below for codes.

Coin Name	Code
42 Coin:	42
300 token:	300
365Coin:	365
404Coin:	404
SixEleven:	611
808:	808
Octocoin:	888
1337:	1337
2015 coin:	2015
Ethereum:	ETH
Litecoin:	LTC
Dash:	DASH
Monero:	XMR
Nxt:	NXT
Dogecoin:	DOGE
ZCash:	ZEC
Bitshares:	BTS
DigiByte:	DGB
XRP:	XRP
BitcoinDark:	BTCD
PeerCoin:	PPC
CraigsCoin:	CRAIG
Bitstake:	XBS
PayCoin:	XPY
ProsperCoin:	PRC
YbCoin:	YBC
DarkKush:	DANK
GiveCoin:	GIVE
KoboCoin:	KOBO
DarkToken:	DT
CETUS Coin:	CETI
Supcoin:	SUP
PetroDollar:	XPD
GeoCoin:	GEO
CleverHash:	CHASH
Spreadcoin:	SPR
NXTI:	NXTI
Insanity Coin:	WOLF
DogeParty:	XDP
Asia Coin:	AC
ACoin:	ACOIN
Aero Coin:	AERO
AlphaCoin:	ALF
Aegis:	AGS
AmericanCoin:	AMC
AlienCoin:	ALN
ApexCoin:	APEX
ArchCoin:	ARCH
Argentum:	ARG
AriCoin:	ARI
AXRON:	AXR
BattleCoin:	BCX
Benjamins:	BEN*
BetaCoin:	BET
BitBean:	BITB
BlueCoin:	BLU
BlackCoin:	BLK
BoostCoin:	BOST
BQCoin:	BQC
MoonCoin:	MOON
ZetaCoin:	ZET
SexCoin:	SXC
Quatloo:	QTL
EnergyCoin:	ENRG
QuarkCoin:	QRK
Riecoin:	RIC
DigiCoin:	DGC
LimeCoinX:	LIMX
BitBar:	BTB
CAIx:	CAIX
ByteCoin:	BTE
BitGem:	BTG*
BitMark:	BTM
CryptoBuk:	BUK
Cachecoin:	CACH
CannabisCoin:	CANN
BottleCaps:	CAP
CashCoin:	CASH
Catcoin:	CAT1
CryptoBullion:	CBX
CannaCoin:	CCN
CinderCoin:	CIN
CINNICOIN:	CINNI
CheckCoin:	CXC
CLAMS:	CLAM
CloakCoin:	CLOAK
CopperLark:	CLR
CosmosCoin:	CMC
ChinaCoin:	CNC
ConcealCoin:	CNL
Community Coin:	COMM
CoolCoin:	COOL
CrackCoin:	CRACK
CraftCoin:	CRC*
CryptCoin:	CRYPT
CasinoCoin:	CSC
eMark:	DEM
Diamond:	DMD
Verge:	XVG
DarkCash:	DRKC
DarkShibe:	DSB
DevCoin:	DVC
EarthCoin:	EAC
E-Gulden:	EFL
Elacoin:	ELC
Einsteinium:	EMC2
Emerald:	EMD
Exclusive Coin:	EXCL
ExeCoin:	EXE
EZCoin:	EZC
Flappy Coin:	FLAP
Fuel2Coin:	FC2
FireflyCoin:	FFC
FIBRE:	FIBRE
FireRoosterCoin:	FRC
FlutterCoin:	FLT
Franko:	FRK
FractalCoin:	FRAC
FastCoin:	FST
FeatherCoin:	FTC
GrandCoin:	GDC
GlobalCoin:	GLC
GoldCoin:	GLD
GalaxyCoin:	GLX
GlyphCoin:	GLYPH
GameLeagueCoin:	GML
GuerillaCoin:	GUE
Halcyon:	HAL
HoboNickels:	HBN
HunterCoin:	HUC
HeavyCoin:	HVC
Hyperstake:	HYP
IceBergCoin:	ICB
Infinite Coin:	IFC
IOCoin:	IOC
IXcoin:	IXC
JumBucks Coin:	JBS
JunkCoin:	JKC
JudgeCoin:	JUDGE
Klondike Coin:	KDC
KeyCoin:	KEY*
KrugerCoin:	KGC
CoinWorksCoin:	LAB*
Legendary Coin:	LGD*
Lucky7Coin:	LK7
LuckyCoin:	LKY
LightSpeedCoin:	LSD
Litebar :	LTB
LitecoinDark:	LTCD
LitecoinX:	LTCX
LibrexCoin:	LXC
LycanCoin:	LYC
MaxCoin:	MAX
MegaCoin:	MEC
MediterraneanCoin:	MED
Minerals Coin:	MIN
MintCoin:	MINT
Cryptsy Mining Contract:	MN
MinCoin:	MNC
MurrayCoin:	MRY
MysteryCoin:	MYST*
MazaCoin:	MZC
NanoToken:	NAN
Nautilus Coin:	NAUT
NavCoin:	NAV
Nybble:	NBL
NeoCoin:	NEC
NetCoin:	NET
Nimbus Coin:	NMB
NoirBits:	NRB
NobleCoin:	NOBL
NoirShares:	NRS
NovaCoin:	NVC
Namecoin:	NMC
NyanCoin:	NYAN
OpalCoin:	OPAL
Orbitcoin:	ORB
OpenSourceCoin:	OSC
PhilosophersStone:	PHS
Cryptsy Points:	POINTS
PotCoin:	POT
PseudoCash:	PSEUD
Protoshares:	PTS*
PhoenixCoin:	PXC
PayCoin:	PYC
Reddcoin:	RDD
RipOffCoin:	RIPO
RonPaulCoin:	RPC
RotoCoin:	RT2
RoyalCoin:	RYC
RazorCoin:	RZR
Saturn2Coin:	SAT2
StableCoin:	SBC
ShadowCash:	SDC
SaffronCoin:	SFR
ShadeCoin:	SHADE
ShieldCoin:	SHLD
SilkCoin:	SILK
SterlingCoin:	SLG
SmartCoin:	SMC
SoleCoin:	SOLE
SpainCoin:	SPA
Spots:	SPT
SecureCoin:	SRC
SSVCoin:	SSV
Stellar:	XLM
SuperCoin:	SUPER
BitSwift:	SWIFT
SyncCoin:	SYNC
SysCoin:	SYS
TagCoin:	TAG
TakCoin:	TAK
TeslaCoin:	TES
TigerCoin:	TGC
TitCoin:	TIT
TorCoin:	TOR
TerraCoin:	TRC
TittieCoin:	TTC
Umbrella:	ULTC
UnbreakableCoin:	UNB
Unobtanium:	UNO
UroCoin:	URO
UnitaryStatus Dollar:	USDE
UltraCoin:	UTC
Utility Coin:	UTIL
VidioCoin:	VDO
ViaCoin:	VIA
VootCoin:	VOOT
VeriCoin:	VRC
WhiteCoin:	WC
WorldCoin:	WDC
SapienceCoin:	XAI
SocialXbotCoin:	XBOT
X11 Coin:	XC
Xcash:	XCASH
Crypti:	XCR
JouleCoin:	XJO
LibertyCoin:	XLB
PrimeCoin:	XPM
StealthCoin:	XST
XXXCoin:	XXX
YAcCoin:	YAC
ZCC Coin:	ZCC
ZedCoins:	ZED
ZiftrCoin:	ZRC*
ByteCoin:	BCN
Elektron:	EKN
XauCoin:	XAU
TimesCoin:	TMC
NEM:	XEM
BurstCoin:	BURST
NuBits:	NBT
StorjCoin:	SJCX
StartCoin:	START
BigCoin:	HUGE
CounterParty:	XCP
MaidSafe Coin:	MAID
007 coin:	007
NuShares:	NSR
MonaCoin:	MONA
SolarFarm:	CELL
TekCoin:	TEK
BitBay:	BAY
Neutron:	NTRN
Sling Coin:	SLING
Vcash:	XVC
CraveCoin:	CRAVE
BlockNet:	BLOCK
Stability Shares:	XSI
Giga Hash:	GHS*
ByteCent:	BYC
GridCoin:	GRC
Gemz Social:	GEMZ
KryptCoin:	KTK
Horizon:	HZ
FairCoin:	FAIR
QoraCoin:	QORA
Gulden:	NLG
RubyCoin:	RBY
PesetaCoin:	PTC
Kore:	KORE
Wild Beast Coin:	WBB
Sonic Screw Driver Coin:	SSD
TileCoin:	XTC
Dnotes:	NOTE
GridPay:	GRID*
FlorinCoin:	FLO
MaieutiCoin:	MMXIV
8BIT Coin:	8BIT
Sativa Coin:	STV
EbolaShare:	EBS
AeroMe:	AM
Coin Magi:	XMG
AmberCoin:	AMBER
JackPotCoin:	JPC*
NakomotoDark:	NKT
JoinCoin:	J
GhostCoin:	GHC
DayTrader Coin:	DTC*
ArtByte:	ABY
LiteDoge:	LDOGE
MasterTraderCoin:	MTR
Triangles Coin:	TRI
SwarmCoin:	SWARM
Boolberry:	BBR
BitCrystal:	BTCRY
BitCredit:	BCR
Pebble Coin:	XPB
Dirac Coin:	XDQ
Folding Coin:	FLDC
SolarCoin:	SLR
Social Media Coin:	SMAC
TruckCoin:	TRK
Ucoin:	U
Unitus:	UIS
CypherPunkCoin:	CYP
UFO Coin:	UFO
Ascension Coin:	ASN
OrangeCoin:	OC
GSM Coin:	GSM
FriendshipCoin:	FSC
NXTTY:	NXTTY
QuBuck Coin:	QBK
BlakeCoin:	BLC
MaryJane Coin:	MARYJ
OmniCron:	OMC
GigCoin:	GIG
CyberCoin:	CC
BitstarCoin:	BITS
LTBCoin:	LTBC
NeosCoin:	NEOS
HyperCoin:	HYPER
Vtorrent:	VTR
MetalCoin:	METAL
PinkCoin:	PINK
GreenCoin:	GRE
XG Sports:	XG
ChildCoin:	CHILD
Instamine Nuggets:	MINE
ROS Coin:	ROS
Unattanium:	UNAT
SlimCoin:	SLM
GAIA Platform:	GAIA
TrustPlus:	TRUST
FantomCoin :	FCN
Cryptonite:	XCN
Curecoin:	CURE
Gridmaster:	GMC
MemoryCoin:	MMC
BitcoinPlus:	XBC
ConSpiracy Coin :	CYC
OctoCoin:	OCTO
MasterCoin:	MSC
EggCoin:	EGG
Coin.2:	C2
GlowShares:	GSX
Camcoin:	CAM
Ribbit Rewards:	RBR
Quotient:	XQN
ICASH:	ICASH
Node:	NODE
SoonCoin:	SOON
BitMiles:	BTMI
Event Token:	EVENT
1Credit:	1CR
ViorCoin:	VIOR
XCoin:	XCO
VirtualMining Coin:	VMC
MarsCoin:	MRS
Viral Coin:	VIRAL
Equilibrium Coin:	EQM
IslaCoin:	ISL
Quicksilver coin:	QSLV
World Trade Funds:	XWT
DeOxyRibose:	XNA
RadonPay:	RDN
SkullBuzz:	SKB
GlobalBoost:	BSTY
CryptoFocus:	FCS
Gambit coin:	GAM
Nexus:	NXS
Crypto Escudo:	CESC
Twelve Coin:	TWLV
EagsCoin:	EAGS
MultiWallet Coin:	MWC
AudioCoin:	ADC
MarsCoin :	MARS
Megastake:	XMS
Sphere Coin:	SPHR
Singular:	SIGU
BitcoinTX:	BTX*
DarkCrave:	DCC
SupplyShock:	M1
DarkBit:	DB
Crypto:	CTO
EdgeCoin:	EDGE
BitLux:	LUX*
FutCoin:	FUTC
Global:	GLOBE
TamaGucci:	TAM
MorpheusCoin:	MRP
Creva Coin:	CREVA
Forever Coin:	XFC
BananaBits:	NANAS
Wood Coin:	LOG
Cerium:	XCE
Anarchists Prime:	ACP
Droidz:	DRZ
GorillaBucks:	BUCKS*
BowsCoin:	BSC
DarkTron:	DRKT
CryptoCircuits:	CIRC
IncaKoin:	NKA
Versa Token:	VERSA
Empyrean:	EPY
Squall Coin:	SQL
PolyBit:	POLY
Piggy Coin:	PIGGY
Charity Coin:	CHA
Milllionaire Coin:	MIL
Crown Coin:	CRW
Genstake:	GEN
PharmaCoin:	XPH
GridMaster:	GRM
Quartz:	QTZ
Arbit Coin:	ARB
Litestar Coin:	LTS
SpinCoin:	SPC
GoldPieces:	GP
Bitz Coin:	BITZ
DubCoin:	DUB
Graviton:	GRAV
MonetaVerde:	MCN
Quazar Coin:	QCN
Hedgecoin:	HEDG
Song Coin:	SONG
BitSeeds:	XSEED
Credits:	CRE
Axiom Coin:	AXIOM
SmileyCoin:	SMLY
Rimbit:	RBT
Chip:	CHIP
SpecCoin:	SPEC
UnCoin:	UNC
Sprouts:	SPRTS
BitZeny:	ZNY
BitQuark:	BTQ
ParkByte:	PKB
StarCoin:	STR*
Synergy:	SNRG
Ghoul Coin:	GHOUL
Hellenic Coin:	HNC
Diggits:	DIGS
Expanse:	EXP
Global Currency Reserve:	GCR
MapCoin:	MAPC
XiaoMiCoin:	MI
Paycon:	CON
NeuCoin:	NEU*
Transfer:	TX
Groestlcoin :	GRS
Siacoin:	SC
CleverCoin:	CLV
Factoids:	FCT
LyraBar:	LYB
Prime-X1:	PXI
CapriCoin:	CPC
Amsterdam Coin:	AMS
Obits Coin:	OBITS
ClubCoin:	CLUB
Radium:	RADS
Emercoin:	EMC
BlitzCoin:	BLITZ
BitHIRE:	HIRE*
EverGreenCoin:	EGC
MindCoin:	MND
I0coin:	I0C
Bata:	BTA
Karmacoin:	KARMA
Decred:	DCR
Nas2Coin:	NAS2
Pakcoin:	PAK
Creditbit :	CRB
DogeCoinDark:	DOGED
Augur:	REP
OKCash:	OK
Revolution VR:	RVR
Synereo:	AMP
HOdlcoin:	HODL
Digix DAO:	DGD
EDRCoin:	EDRC
Lisk:	LSK
Waves:	WAVES
Hitcoin:	HTC
Gamecredits:	GAME
Dashcoin:	DSH
DubaiCoin:	DBIC
HiCoin:	XHI
Spots:	SPOTS
BiosCrypto:	BIOS
CabbageUnit:	CAB
CarpeDiemCoin:	DIEM
GameBetCoin:	GBT
SARCoin:	SAR*
RedCrowCoin:	RCX
PWR Coin:	PWR
TrumpCoin:	TRUMP
PrismChain:	PRM
BitCrystals:	BCY
Rubies:	RBIES
Steem:	STEEM
BillaryCoin:	BLRY
WhiteCoin:	XWC
Dotcoin:	DOT
Scotcoin:	SCOT
Darknet:	DNET
BitalphaCoin:	BAC
International Diamond Coin:	XID*
Thecreed:	TCR
PostCoin:	POST
Influxcoin:	INFX
EthereumScrypt:	ETHS
Phalanx:	PXL
NumbersCoin:	NUM
SoulCoin:	SOUL
Ionomy:	ION
GrownCoin:	GROW
SuperNET:	UNITY
OldSafeCoin:	OLDSF
SunShotCoin:	SSTC
NetworkCoin:	NETC
GPU Coin:	GPU
Think And Get Rich Coin:	TAGR
HempCoin:	HMP
Adzcoin:	ADZ
Gapcoin:	GAP
MayaCoin:	MYC
InvisibleCoin:	IVZ
VirtaCoin:	VTA
SaluS:	SLS
SoilCoin:	SOIL
DigiCube:	CUBE
YoCoin:	YOC
Coin:	COIN*
VapersCoin:	VPRC
AlpaCoin:	APC
Steps:	STEPS
DebitCoin:	DBTC
Universal Currency:	UNIT
AEON:	AEON
MoinCoin:	MOIN
SibCoin:	SIB
EuropeCoin:	ERC
AdvancedInternetBlock:	AIB
PrimeChain:	PRIME
BERNcash:	BERN
BigUp:	BIGUP
Krypton:	KR
RevolverCoin:	XRE
Pepe:	MEME
DragonSphere:	XDB
Anti Bitcoin:	ANTI
BreakoutCoin:	BRK
ColossusCoinXT:	COLX
Mineum:	MNM
Asiadigicoin:	ADCN
ZeitCoin:	ZEIT
2GiveCoin:	2GIVE
Cryptographic Anomaly:	CGA
SwingCoin:	SWING
SafeExchangeCoin:	SAFEX
Nebuchadnezzar:	NEBU
AcesCoin:	AEC
Francs:	FRN
Aiden:	ADN
Pulse:	PULSE
Number7:	N7
Cygnus:	CYG
LGBTQoin:	LGBTQ
Uther:	UTH
MediumProject:	MPRO
KATZcoin:	KAT
Supreme:	SPM
Mojocoin:	MOJO
Bela:	BELA
Flash:	FLX
BolivarCoin:	BOLI
CludCoin:	CLUD
DimeCoin:	DIME
FlyCoin:	FLY
High Voltage Coin:	HVCO
GIZMOcoin:	GIZ
GrexitCoin:	GREXIT
Carboncoin:	CARBON
DigiEuro:	DEUR
Turron:	TUR
LemonCoin:	LEMON
STRESScoin:	STS
Dark Lisk:	DISK
NevaCoin:	NEVA
Cryptokenz:	CYT
Fuzzballs:	FUZZ
Nukecoinz:	NKC
SecretCoin:	SCRT
Ratecoin:	XRA
XanaxCoin:	XNX
StarCoin:	STAR*
Stakerush:	STHR
Digital Bullion Gold:	DBG
BonesCoin:	BON
WMCoin:	WMC
GothicCoin:	GOTX
FlavorCoin:	FLVR
ShrekCoin:	SHREK
Stakers:	STA*
Rise:	RISE
Revenu:	REV
PabyosiCoin:	PBC
Obscurebay:	OBS
ExitCoin:	EXIT
EducoinV:	EDC
Clinton:	CLINT
Clockcoin:	CKC
VIP Tokens:	VIP
NXEcoin:	NXE
ZoomCoin:	ZOOM
DT Token:	DRACO
YobitVirtualCoin:	YOVI
OrlyCoin:	ORLY
KubosCoin:	KUBO
InceptionCoin:	INCP
SharkCoin:	SAK
EvilCoin:	EVIL
OmegaCoin:	OMA
MonetaryUnit:	MUE
CobraCoin:	COX
Bancor Network Token:	BNT
Destiny:	DES
16BitCoin:	BIT16
Project Decorum:	PDC
CometCoin:	CMT
ChessCoin:	CHESS
SpaceCoin:	SPACE
ReeCoin:	REE
Liquid:	LQD
Marvelous:	MARV
XDE II:	XDE2
VectorCoin 2.0 :	VEC2
Omni:	OMNI
GenesysCoin:	GSY
TrollTokens:	TKN*
Let it Ride:	LIR
MMNXT :	MMNXT
ScryptCoin:	SCRPT
LBRY Credits:	LBC
Specie:	SPX
Steem Backed Dollars:	SBD*
CryptoJacks:	CJ
Kraken:	KRAK
Dlisk:	DLISK
iBankCoin:	IBANK
Stratis:	STRAT
Voyacoin:	VOYA
EnterCoin (ENTER):	ENTER
World Gold Coin:	WGC
BitMoon:	BM
Frankywillcoin:	FRWC
Psilocybin:	PSY
ExtremeCoin:	XT
RustCoin:	RUST
NewZealandCoin:	NZC
SingularDTV:	SNGLS
Xaurum:	XAUR
BitFinex Tokens:	BFX
Uniqredit:	UNIQ
ChronosCoin:	CRX
Decent:	DCT
PokeChain:	XPOKE
MudraCoin:	MUDRA
WarpCoin:	WARP
Coinomat:	CNMT
PizzaCoin:	PIZZA
Lutetium Coin:	LC
Heat Ledger:	HEAT
Iconomi:	ICN
ExaByte (EXB):	EXB
Wings DAO:	WINGS
Cryptodex:	CDX*
ReturnBit:	RBIT
deCLOUDs:	DCS.
Komodo:	KMD
GoldBlocks:	GB
NEO:	NEO
Anoncoin:	ANC
Syndicate:	SYNX
Mass Coin:	MC
E-Dinar Coin:	EDR
Jewels:	JWL
WayCoin:	WAY
MollyCoin:	TAB
Trigger:	TRIG
bitCNY:	BITCNY
bitUSD:	BITUSD
Autumncoin:	ATM*
Save The Ocean:	STO
Sense:	SNS
Fusion:	FSN*
CarterCoin:	CTC
TotCoin:	TOT
Bitcloud:	BTD
ArkDAO:	BOTS
MedicCoin:	MDC
FuturePoints:	FTP
Zeta2Coin:	ZET2
CovenCoin:	COV*
Karbo:	KRB
Tellurion:	TELL
EneCoin:	ENE
TDFB:	TDFB
BlockPay:	BLOCKPAY
BitTokens:	BXT
MustangCoin:	MST
Goonies:	GOON
Veltor:	VLT
ZoneCoin:	ZNE
DickCoin:	DCK
Circuits of Value:	COVAL
DarkGold:	DGDC
TodayCoin:	TODAY
Verium:	VRM
RootCoin:	ROOT
FirstBlood:	1ST
Gold Pressed Latinum:	GPL
DopeCoin:	DOPE
B3 Coin:	B3
FCoin:	FX
Pioneershares:	PIO
PROUD Money:	PROUD
Samsara Coin:	SMSR
Ubiqoin:	UBIQ
Armory Coin:	ARM
RingCoin:	RING
ERBCoin:	ERB
Lazarus:	LAZ
FonzieCoin:	FONZ
BitCurrency:	BTCR
FaucetCoin:	DROP*
Save and Gain:	SANDG
SteamPunk:	PNK
Dark Moon:	MOOND
DollarCoin:	DLC
Sentaro:	SEN
Swiscoin:	SCN
Wexcoin:	WEX
Lathaan:	LTH
BitBronze:	BRONZ
Shilling:	SH
BuzzCoin:	BUZZ
Mind Gene:	MG
PSIcoin:	PSI
Opair:	XPO
NoLimitCoin:	NLC
PesoBit:	PSB
Beats:	XBTS
Fitcoin:	FIT
PantherCoin:	PINKX
FireCoin:	FIRE
Unfed Coin:	UNF
SportsCoin:	SPORT
Peerplays:	PPY
NineElevenTruthCoin:	NTC
EGOcoin:	EGO
BitluckCoin:	BTCL*
RCoin:	RCN*
Mycelium Token:	MT
Tianhe:	TIA
GBR Coin:	GBRC
UPcoin:	XUP
Halloween Coin:	HALLO
BaseballCardCoin:	BBCC
EmiratesGoldCoin:	EMIGR
BighanCoin:	BHC
Craftcoin:	CRAFT
Invictus:	INV
OlympCoin:	OLYMP
DelightPay:	DPAY
Atomic Coin:	ATOM
Hacker Gold:	HKG
AntiLitecoin:	ANTC
JobsCoin:	JOBS
DogeGoreCoin:	DGORE
The Hempcoin:	THC
Tetra:	TRA
Resumeo Shares:	RMS
FujiCoin:	FJC
Vaporcoin:	VAPOR
SydPakCoin:	SDP
Recovery Right Tokens:	RRT
ZCoin:	XZC
Premium:	PRE
CaliphCoin:	CALC
LeaCoin:	LEA
Californium:	CF
CrankCoin:	CRNK
CoffeeCoin:	CFC
Victoriouscoin:	VTY
Safecoin:	SFE
Ardor:	ARDR
BlackShadowCoin:	BS
JiffyCoin:	JIF
CrabCoin:	CRAB
Aircoin:	AIR*
President Clinton:	HILL
ForexCoin:	FOREX
Moneta:	MONETA
Eclipse:	EC
Rublebit:	RUBIT
HappyCreatorCoin :	HCC
BrainCoin:	BRAIN
Vertex:	VTX
KRCoin:	KRC
RoyalCoin:	ROYAL
BigLifeCoin:	LFC
Zurcoin:	ZUR
NubisCoin:	NUBIS
Tennet:	TENNET
PeaceCoin:	PEC
Goldmaxcoin:	GMX
32Bitcoin:	32BIT
GanjaCoin V2:	GNJ
TeamUP:	TEAM
ScryptToken:	SCT
LanaCoin:	LANA
Elementrem:	ELE
GuccioneCoin:	GCC
AndromedaCoin:	AND
Byteball:	GBYTE
EqualCoin:	EQUAL
SweetStake:	SWEET
2BACCO Coin:	2BACCO
DarkKnightCoin:	DKC
Community Coin:	COC
ChoofCoin:	CHOOF
CashOut:	CSH
ZClassic:	ZCL
RoyalCoin 2.0:	RYCN
Pabyosi Coin:	PCS
NetBit:	NBIT
WineCoin:	WINE
Darcrus:	DAR
ARK:	ARK
InflationCoin:	IFLT
ZCashDarkCoin:	ZECD
Zcrypt:	ZXT
WashingtonCoin:	WASH
TeslaCoilCoin:	TESLA
LuckyBlocks:	LUCKY
vSlice:	VSL
Troll Payment:	TPG
LEOcoin:	LEO
Midnight:	MDT
CBD Crystals:	CBD
PosEx:	PEX
InsaneCoin:	INSANE
Golem Network Token:	GNT
PenCoin:	PEN*
LuckChain:	BASH
FameCoin:	FAME
LiviaCoin:	LIV
Sex Pistols:	SP
MegaFlash:	MEGA
Veros:	VRS
Arab League Coin:	ALC
EtherDoge:	DOGETH
KiloCoin:	KLC
Hush:	HUSH
BitLuckCoin:	BTLC
Dream8Coin:	DRM8
FistBump:	FIST
Ebitz:	EBZ
Digital Rupees:	DRS
Free Game Zone:	FGZ
BosonCoin:	BOSON
ArtexCoin:	ATX
PlatiniumCoin:	PNC
BeardDollars:	BRDD
Time:	TIME
BipCoin:	BIP
XenCoin:	XNC
EmberCoin:	EMB
Coin to the Future:	BTTF
DollarOnline:	DLR
Cosmic:	CSMIC
FirstCoin:	FIRST
SpaceCash:	SCASH
XenixCoin:	XEN
JIO Token:	JIO
iWallet:	IW
Janus:	JNS
TrickyCoin:	TRICK
DeltaCredits:	DCRE
FreeCoin:	FRE
NPCcoin:	NPC
PLNCoin:	PLNC
Digigems:	DGMS
Icobid:	ICOB
AquariusCoin:	ARCO
Kurrent:	KURT
Creatio:	XCRE
Eternity:	ENT
UR:	UR
Metal Music v3:	MTLM3
Old Dogs New Tricks:	ODNT
Eurocoin:	EUC
CoolDarkCoin:	CCX
BitcoinFast:	BCF
SeedShares:	SEEDS
Tokes:	TKS
BitConnect Coin:	BCCOIN
ShortyCoin:	SHORTY
Procom:	PCM
Kernalcoin:	KC
CoralPay:	CORAL
BAM:	BamitCoin
Nexium:	NXC
MoneyCoin:	MONEY
Blackstar:	BSTAR
Horse Power:	HSP
HazMatCoin:	HZT
CryptoSpots:	CS
PoolStamp:	XSP
CryptoCarbon:	CCRB
BullshitCoin:	BULLS
Incent:	INCNT
Iconic:	ICON
NewInvestCoin:	NIC
AvonCoin:	ACN
Enigma:	XNG
Cannabis Industry Coin:	XCI
LookCoin:	LOOK
Loco:	LOC
MMXVI:	MMXVI
TrustCoin:	TRST
MIScoin:	MIS
WorldPay:	WOP
ConquestCoin:	CQST
Impulse Coin:	IMPS
InCoin:	IN
TheChiefCoin:	CHIEF
Goat:	GOAT
AnalCoin:	ANAL
Russiacoin:	RC
PandaCoin:	PND
PXcoin:	PX
Canada eCoin:	CND*
OptionCoin:	OPTION
Avatar Coin:	AV
Limited Coin:	LTD
GameUnits:	UNITS
HeelCoin:	HEEL
GAKHcoin:	GAKH
Shift:	SHIFT
S88 Coin:	S8C
Leverage Coin:	LVG
DraculaCoin:	DRA
Allsafe:	ASAFE2
LiteCreed:	LTCR
Quebecoin:	QBC
ProCoin:	XPRO
Astral:	AST*
GiftNet:	GIFT
PureVidz:	VIDZ
Incrementum:	INC
PentaCoin:	PTA
AcidCoin:	ACID
ZLiteQubit:	ZLQ
RadicalCoin:	RADI
ReturnCoin:	RNC
Golos:	GOLOS
Pascal Coin:	PASC
TwisterCoin:	TWIST
PayPeer:	PAYP
DarkEther:	DETH
YAYcoin:	YAY
YesCoin:	YES
LeninCoin:	LENIN
MrsaCoin:	MRSA
OsmiumCoin:	OS76
BitBoss:	BOSS
Maker:	MKR
Bikercoins:	BIC
CryptoPennies:	CRPS
Motocoin:	MOTO
NeptuneClassic:	NTCC
Numismatic Collections:	XNC*
HexxCoin:	HXX
Ghost Coin:	SPKTR
MachineCoin:	MAC
SelenCoin:	SEL
Noocoin:	NOO
23 Skidoo:	CHAO
GoldenBird:	XGB
YamahaCoin:	YMC
JokerCoin:	JOK
GravityBit:	GBIT
TeCoin:	TEC
BombCoin:	BOMB
Ride My Car:	RIDE
Private Instant Verified Transaction:	PIVX
Klingon Empire Darsek:	KED
Coino:	CNO
WealthCoin:	WEALTH
Internet of People:	IOP
Spectre:	XSPEC
Pepe Cash:	PEPECASH
Clickcoin:	CLICK
Elysium:	ELS
KushCoin:	KUSH
Eryllium:	ERY
Pluton:	PLU
President Trump:	PRES
BitzCoin:	BTZ
Opes:	OPES
Waves Community Token:	WCT
Ubiq:	UBQ
Ratio:	RATIO
Babes and Nerds:	BAN
NiceCoin:	NICE
SmurfCoin:	SMF
CryptoWorldXToken:	CWXT
TechCoin:	TECH
CircuitCoin:	CIR
LePenCoin:	LEPEN
RoundCoin:	ROUND
MarijuanaCoin:	MAR
MarxCoin:	MARX
Tatiana Coin:	TAT
HazeCoin:	HAZE
Printerium:	PRX
Neurocoin:	NRC
PacCoin:	PAC
Impeach:	IMPCH
ErrorCoin:	ERR
TrueInvestmentCoin:	TIC
NukeCoin:	NUKE
EveryonesCoin:	EOC
Solarflarecoin:	SFC
JaneCoin:	JANE
ParanoiaCoin:	PARA
MasterMint:	MM
Citadel:	CTL
NinjaDoge:	NDOGE
Zilbercoin:	ZBC
Melon:	MLN
FirstCoin:	FRST
TenX:	PAY
OroCoin:	ORO
Alexandrite:	ALEX
TrashBurn:	TBCX
MasterCar:	MCAR
TechShares:	THS
AcesCoin:	ACES
United Arab Emirates Coin:	UAEC
EagleCoin:	EA
Persistent Information Exchange:	PIE
CreativeChain:	CREA
WisdomCoin:	WISC
BeaverCoin:	BVC
FindCoin:	FIND
MeLite:	MLITE
StalinCoin:	STALIN
TattooCoin:	TSE
VaultCoin:	VLTC
BioBar:	BIOB
Swarm City Token:	SWT
Pascal Lite:	PASL
Zero:	ZER
Canada eCoin:	CDN
Netko:	NETKO
Zoin:	ZOI
Honey:	HONEY
MartexCoin:	MXT
Musicoin:	MUSIC
Databits:	DTB
BitVegan:	VEG
Mbitbooks:	MBIT
BitVolt:	VOLT
Edgeless:	EDG
BankCoin:	B@
BestChain:	BEST
ChainCoin:	CHC
Zennies:	ZENI
PlanetCoin:	PLANET
DuckDuckCoin:	DUCK
BnrtxCoin:	BNX
BattleStake:	BSTK
RenosCoin:	RNS
DubaiCoin:	DBIX
AMIS:	AMIS
Kayı:	KAYI
VirtacoinPlus:	XVP
Doubloon:	BOAT
TajCoin:	TAJ
Impact:	IMX
CryptoJournal:	CJC
Amygws:	AMY
Cubits:	QBT
StarCredits:	SRC*
EB3coin:	EB3
The Vegan Initiative:	XVE
FazzCoin:	FAZZ
Aptcoin:	APT
BlazerCoin:	BLAZR
ArpaCoin:	ARPA
Boats and Bitches:	BNB*
Universe:	UNI
ECOcoin:	ECO
Solaris:	XLR
Dark:	DARK
DonationCoin:	DON
Mercury:	MER
WavesGO:	WGO
iEx.ec:	RLC
Atmos:	ATMOS
InPay:	INPAY
wBTC:	WBTC*
Visio:	VISIO
HappyCoin:	HPC
Giotto Coin:	GOT
Coinonat:	CXT
EmporiumCoin:	EMPC
Gnosis:	GNO
Legends Cryptocurrency:	LGD
Token as a Service:	TAAS
SwagBucks:	BUCKS
XtraBYtes:	XBY
Guppy:	GUP
MacronCoin:	MCRN
Lunyr:	LUN
Condensate:	RAIN
WeAreSatoshi:	WSX
IvugeoEvolutionCoin:	IEC
Independent Money System:	IMS
ArgusCoin:	ARGUS
Centurion:	CNT
LomoCoin:	LMC
TokenCard :	TKN
Bitcoin Scrypt:	BTCS
ProCurrency:	PROC
GoldReserve:	XGR
WarCoin:	WRC*
BenjiRolls:	BENJI
Humaniq:	HMQ
Blockchain Capital:	BCAP
ParallelCoin:	DUO
RiptoBuX:	RBX
GrowthCoin:	GRW
Apx:	APX
MiloCoin:	MILO
OldV:	OLV
MinersReward:	MRT
IOU1:	IOU
Prizm:	PZM
Phreak:	PHR
Aragon:	ANT
PupaCoin:	PUPA
RiceCoin:	RICE
C-Bits:	XCT
Degas Coin:	DEA
Redcoin:	RED
ZSEcoin:	ZSE
Coinmatic:	CTIC
TappingCoin:	TAP
BitOKX:	BITOK
Primalbase:	PBT
MilkCoin:	MUU
Infinium-8:	INF8
HTML5 Coin:	HTML5
Etheroll:	DICE
Subscriptio:	SUB*
Ultimate Secure Cash:	USC
DuxCoin:	DUX
PoisonIvyCoin:	XPS
EquiTrader:	EQT
Insane Coin:	INSN
Basic Attention Token:	BAT
Manet Coin:	MAT*
F16Coin:	F16
HamsterCoin:	HAMS
QTUM:	QTUM
NefariousCoin:	NEF
BOScoin:	BOS
Qwark:	QWARK
IOTA:	IOT
Quantum Resistant Ledger:	QRL
Adelphoi:	ADL
E-CurrencyCoin:	ECC*
Patientory:	PTOY
ZrCoin:	ZRC
Lykke:	LKK
Espers:	ESP
SatoshiMadness:	MAD*
Dynamic:	DYN
Sequence:	SEQ
MCAP:	MCAP
Mysterium:	MYST
Veritaseum:	VERI
SONM:	SNM
Skycoin:	SKY
Cofound.it:	CFI
Status Network Token:	SNT
AventCoin:	AVT
Civic:	CVC
iXledger:	IXT
Dent:	DENT
Starta:	STA
True Flip Lottery:	TFL
Ergo:	EFYT
Tezos:	XTZ
Numeraire:	NMR
Quantum:	QAU
EcoBit:	ECOB
Polybius:	PLBT
Tether:	USDT
Nano:	NANO
Ahoolee:	AHT
ATB coin:	ATB
Blocktix:	TIX
ChanCoin:	CHAN
Compcoin:	CMP
Rivetz:	RVT
Harbour DAO:	HRB
Nimiq :	NIM
Blox:	CDT
ACT:	ACT
district0x:	DNT
Suretly:	SUR
CryptoPing:	PING
MakeItViral:	MIV
DAO.casino:	BET*
Santiment:	SAN
Kin:	KIN
Wagerr:	WGR
Elastic:	XEL
NVO:	NVST
FunFair:	FUN
FunCoin:	FUNC
PAquarium:	PQT
Giga Watt:	WTT
Metal:	MTL
Hive Project:	HVN
MyBit:	MYB
Populous:	PPT
SunContract:	SNC
Starbase:	STAR
Corion:	COR
Rialto.AI:	XRL
Orocrypt:	OROC
OpenANX:	OAX
Monster Byte Inc:	MBI
Digital Developers Fund:	DDF
DIMCOIN:	DIM
Gilgam:	GGS
EncrypGen:	DNA
FundYourselfNow:	FYN
FundRequest:	FND
Dinastycoin:	DCY
CryptoForecast:	CFT
Denarius:	DNR
DigitalPrice:	DP
Virta Unique Coin:	VUC
Bitcoin Planet:	BTPL
Unify:	UNIFY
ImperialCoin:	IPC
BritCoin:	BRIT
Ammo Rewards:	AMMO
SocialCoin:	SOCC
Mass.Cloud:	MASS
LATOKEN:	LA
IMMLA:	IML
Exchange Union:	XUC
BitJob:	STU
Pillar:	PLR
GeoFunders:	GUNS
InvestFeed:	IFT
BitClave:	CAT*
Propy:	PRO
SynchroCoin:	SYC
Indorse:	IND
Bowhead Health:	AHT*
TribeToken:	TRIBE
0x:	ZRX
Tierion:	TNT
Presearch:	PRE*
COSS:	COSS
Storm:	STORM
Napoleon X:	NPX
Storj:	STORJ
Scorecoin:	SCORE
OmiseGo:	OMG
Octanox:	OTX
Equibit:	EQB
Voise:	VOISE
EthBits:	ETBS
Crypviser:	CVCOIN
DCORP:	DRP
ArcticCoin:	ARC
Bogcoin:	BOG
NeverDie:	NDC
Po.et:	POE
AdToken:	ADT
Aeternity:	AE
Useless Ethereum Token:	UET
Particl:	PART
Agoras Token:	AGRS
BeachCoin:	SAND
AICoin:	XAI*
DMarket:	DMT
DAS:	DAS
Adshares:	ADST
BlockCAT:	CAT
CoinJob:	XCJ
NoLimitCoin:	NLC2
Linda:	LINDA
King93:	KING
Anacrypt:	ANCP
Reality Clash:	RCC
RootProject:	ROOTS
Sosnovkino:	SNK
CryptoABS:	CABS
Opus:	OPT
OpenZen:	ZNT
Bits Digit:	BITSD
LeviarCoin:	XLC
Skincoin:	SKIN
Mothership:	MSP
HireMatch:	HIRE
REAL:	REAL
DentalFix:	DFBT
EQUI:	EQ
Wolk:	WLK
Viberate:	VIB
DeepOnion:	ONION
Bitcore:	BTX
iDice:	ICE
Sphre AIR:	XID
gCn Coin:	GCN
Cosmos:	ATOM*
Decentraland:	MANA
ICO OpenLedger:	ICOO
Timereum:	TME
SmartCash:	SMART
Signatum:	SIGT
Onix:	ONX
CoEval:	COE
Wink:	WINK
Cream:	CRM
Bitcoin Cash:	BCH
DigiPulse:	DGPT
Mobius:	MOBI
BitDice:	CSNO
KickCoin:	KICK
Solar DAO:	SDAO
Stox:	STX
Binance Coin:	BNB
Core Group Asset:	CORE
Kencoin:	KEN
Qvolta:	QVT
Ties Network:	TIE
Autoria:	AUT
CodeTract:	CTT
Growers International:	GRWI
Monkey:	MNY
Monetha:	MTH
CCCoin:	CCC
Umbrella Coin:	UMC
Bitmxittz:	BMXT
Gas:	GAS
FileCoin:	FIL
Oceanlab:	OCL
Benjacoin:	BNC
Tomahawkcoin:	TOM
Bytom:	BTM*
Asch:	XAS
SMNX:	SMNX
Dentacoin:	DCN
Agrello Delta:	DLT
Macroverse:	MRV
Embers:	MBRS
Substratum Network:	SUB
Memessenger:	MET
Neblio:	NEBL
Prospectors:	PGL
Monoeci:	XMCC
Cash Poker Pro:	CASH*
CampusCoin:	CMPCO
DetectorToken:	DTCT
Centra:	CTR
Wavesnode.net:	WNET
Paragon:	PRG
ThankYou:	THNX
HealthyWorm:	WORM
Fuck Token:	FUCK
Veredictum:	VNT
Smart Investment Fund Token:	SIFT
Ignis:	IGNIS
IwToken:	IWT
JustDatingSite:	JDC
Intelligent Trading:	ITT
BlockLancer:	LNC
Aigang:	AIX
Everex:	EVX
Eternal Coin:	XEC
Entropy Token:	ENTRP
ICOBox:	ICOS
Lampix:	PIX
MediBond:	MEDI
Hello Gold:	HGT
Litra:	LTA
Nimfamoney:	NIMFA
Scorista:	SCOR
CPROP:	MLS
KexCoin:	KEX
Cobinhood:	COB
Bitradio:	BRO
Minex:	MINEX
ATLANT:	ATL
Magos:	MAG*
Draftcoin:	DFT
Vechain:	VET
Utrust:	UTK
Latium:	LAT
Sojourn Coin:	SOJ
Hedge Token:	HDG
Stakecoin:	STCN
SqPay:	SQP
Etheriya:	RIYA
Ethereum.Link:	LNK
Ambrosus:	AMB
Wanchain:	WAN
GoldMint:	MNTP
AltoCar:	ALTOCAR
Credo:	CFT*
BANKEX:	BKX
Boulle:	BOU
Oxycoin:	OXY
Tap Project:	TTT
Acumen:	AMT
Gimli:	GIM
NewYorkCoin:	NYC
LiteBitcoin:	LBTC
FrazCoin:	FRAZ
EasyMine:	EMT
Gx Coin:	GXC
Hubii Network:	HBT
Kronecoin:	KRONE
Scrypto:	SRT
Avalon:	AVA
BuildTeam:	BT
AdCoin:	ACC
Ar.cash:	AR*
Z2 Coin:	Z2
Linx:	LINX
CoinonatX:	XCXT
BlakeStar:	BLAS
GoodCoin:	GOOD
Sociall:	SCL
Travel Coin:	TRV
Cryptum:	CRTM
Exscudo:	EON
Primas:	PST
Matryx:	MTX
Privatix:	PRIX
CarTaxi:	CTX
Enjin Coin:	ENJ
Cryptonex:	CNX
Dropcoin:	DRC
Etherparty:	FUEL
TokenStars:	ACE
Worldcore:	WRC
Waltonchain:	WTC
Breakout Stake:	BRX
U.CASH:	UCASH
WRTcoin:	WRT
Ormeus Coin:	ORME
Deep Gold:	DEEP
ToTheMoon:	TMT*
Wish Finance:	WSH
ARNA Panacea:	ARNA*
AB-Chain:	ABC
Papyrus:	PRP
Blackmoon Crypto:	BMC
Skrilla Token:	SKR*
3DES:	3DES
Paycentos:	PYN
Kapu:	KAPU
Sense Token:	SENSE
Cappasity:	CAPP
BLOCKv:	VEE
Facecoin:	FC
Ripio:	RCN
Doc.ai Neuron:	NRN
Eventchain:	EVC
ChainLink:	LINK
Crowdwiz:	WIZ
Eidoo:	EDO
A-Token:	ATKN
Kyber Network:	KNC
Rustbits:	RUSTBITS
Imbrex:	REX
Ethereum Dark:	ETHD
Sumokoin:	SUMO
Hydrominer:	H2O
Crypto Tickets:	TKT
Rhea:	RHEA
Maecenas:	ART
DomRaider:	DRT
Snovio:	SNOV
DreamTeam Token:	DREAM
TrackNetToken:	MTN
StockBet:	STOCKBET
Algo.Land:	PLM
Salt Lending:	SALT
Sandcoin:	SND
Experience Points:	XP
Loopring:	LRC
Hshare:	HSR
Gladius:	GLA
Zenome:	ZNA
EZMarket:	EZM
Obsidian:	ODN
ClearPoll:	POLL
Moya Token:	MTK
Cashaa:	CAS
MiniApps:	MAT
Global Jobcoin:	GJC
Wi Coin:	WIC
Webcoin:	WEB
WandX:	WAND
Elixir:	ELIX
eBitcoin:	EBTC
Hackspace Capital:	HAC
Cardano:	ADA
Yoyow:	YOYOW
Regalcoin:	REC
Bismuth:	BIS
Opporty:	OPP
Ice Rock Mining:	ROCK2
Earth Token:	EARTH
ICON Project:	ICX
Vsync:	VSX
WishFinance:	WISH*
FLASH coin:	FLASH
Graft Blockchain:	GRFT
BitcoinZ:	BTCZ
Crazy Coin:	CZC
PayPie:	PPP
Peerguess:	GUESS
CanYaCoin:	CAN
Metaverse:	ETP
Esports.com:	ERT
LakeBanker:	BAC*
FLiK:	FLIK
Multibot:	MBT
Javvy:	JVY
ALISmedia:	ALIS
Leverj:	LEV
Arbi:	ARBI
Eloplay:	ELT
Request Network:	REQ
Aeron:	ARN
Datum:	DAT
VIBEHub:	VIBE
Rockchain:	ROK
X Real Estate Development:	XRED
Chronologic:	DAY
AirSwap:	AST
Gameflip:	FLP
HextraCoin:	HXT
Cindicator:	CND
Prosense.tv:	VRP*
NetM:	NTM
TrezarCoin:	TZC
Enigma:	ENG
Musiconomi:	MCI
Covesting:	COV
Worldwide Asset eXchange:	WAX
AirToken:	AIR
Fujinto:	NTO
ATC Coin:	ATCC
Kolion:	KOLION
Wild Crypto:	WILD
eLTC:	ELTC2
ILCoin Token:	ILCT
Power Ledger:	POWR
Crypto20:	C20
Anryze:	RYZ
GenXCoin:	GXC*
Elements:	ELM
TerraNovaCoin:	TER
CybCSec Coin:	XCS
Bitqy:	BQ
Caviar:	CAV
Clout:	CLOUT
Propthereum:	PTC*
WaBi:	WABI
Everus:	EVR
TOA Coin:	TOA
Monaize:	MNZ
VIVO Coin:	VIVO
Red Pulse Phoenix:	PHX
Moeda:	MDA
Zeusshield:	ZSC
Aureus:	AURS
Change:	CAG
Playkey:	PKT
Social Media Market:	SMT**
e-Chat:	ECHT
Internxt:	INXT
Authorship:	ATS
RG Coin:	RGC
EthBet:	EBET
Revain:	R
Modum:	MOD
Bitcomo:	BM*
CryptoPay:	CPAY
Rupee:	RUP
Bonpay:	BON*
AppCoins:	APPC
WhaleCoin:	WHL
Bitcoin Gold:	BTG
UpToken:	UP
Ethereum Gold:	ETG
WomenCoin:	WOMEN
Theresa May Coin:	MAY
Render Token:	RNDR
Eddie coin:	EDDIE
Soma:	SCT*
NamoCoin:	NAMO
Kucoin:	KCS
GATCOIN:	GAT
Ethereum Blue:	BLUE
Follow Coin:	FLLW
Wyrify:	WYR
Vezt:	VZT
IndiCoin:	INDI
LUXCoin:	LUX
TBIS token:	BAR
Pirl:	PIRL
Ethereum Cash:	ECASH
WePower:	WPR
Dragonchain:	DRGN
ODMCoin:	ODMC
CyberTrust:	CABS*
BROTHER:	BRAT
Dynamic Trading Rights:	DTR
CryptoInsight:	TKR
SelfKey:	KEY
EthereumLite:	ELITE
Xios:	XIOS
DOVU:	DOV
Electroneum:	ETN
Realisto:	REA
Avesta:	AVE
Xenon:	XNN
Bitcloud 2.0:	BTDX
Lendoit:	LOAN*
Data Trading:	DTT*
ZABERcoin:	ZAB
Modulum:	MDL*
Bitfinex Bitcoin Future:	BT1
Bitcoin SegWit2X:	BT2
Sharpe Capital:	SHP*
Jincor:	JCR
Extreme Sportsbook:	XSB
ATMChain:	ATM
eBoost:	EBST
KekCoin:	KEK
AidCoin:	AID
BlackholeCoin:	BHC*
AltCommunity Coin:	ALTCOM
Simple Token:	OST
Streamr DATAcoin:	DATA
ugChain:	UGC
Datacoin:	DTC
HEROcoin:	PLAY
Pure:	PURE
Cloud:	CLD
Open Trading Network:	OTN
PoSToken:	POS
REBL:	REBL
NEO Gold:	NEOG
ExchangeN:	EXN
INS Ecosystem:	INS
Tracto:	TRCT
UnikoinGold:	UKG
Bitcoin Red:	BTCRED
Project J:	JTX
AIX:	AXT
Neumark:	NEU
Rupaya:	RUPX
BlueDragon:	BDR
Infinity Economics:	XIN
Dutch Coin:	DUTCH
Trade.io:	TIO
Huncoin:	HNC*
MadCoin:	MDC*
Pura:	PURA
Innova:	INN
Decision Token:	HST
BlockMason Credit Protocol:	BCPT
Bitdeal:	BDL
COMSA:	CMS
Billionaire Token:	XBL
Project Zephyr:	ZEPH
ATFS Project:	ATFS
Galaxy eSolutions:	GES
Nuls:	NULS
Phore:	PHR*
LitecoinCash:	LCASH
Confido:	CFD
SophiaTX:	SPHTX
PlusCoin:	PLC
SirinLabs:	SRN
WiserCoin:	WSC
Decent.bet:	DBET
Go!:	XGOX
Newbium:	NEWB
LIFE:	LIFE
Russian Mining Coin:	RMC
Credo:	CREDO
Masari:	MSR
ConnectJob Token:	CJT
Ethersportcoin:	ESC*
Envion:	EVN
Bankera:	BNK
Ellaism:	ELLA
BlockPool:	BPL
RocketCoin :	ROCK*
Droxne:	DRXNE
Sakuracoin:	SKR
Grid+:	GRID
PlatinumBAR:	XPTX
Genesis Vision:	GVT
Energi Token:	ETK
Astronaut:	ASTRO
Mercury Protocol:	GMT
Emphy:	EPY*
Soarcoin:	SOAR
Experty:	EXY
Interstellar Holdings:	HOLD*
MinexCoin:	MNX
Credits:	CRDS
Viuly:	VIU
Scorum:	SCR*
Düber:	DBR
Advanced Browsing Token:	ABT
Giftcoin:	GFT
STAC:	STAC
Quantstamp:	QSP
RiptideCoin:	RIPT
BitBoost:	BBT
GoByte:	GBX
Castle:	CSTL
Insta Cash Coin:	ICC
Jibrel Network Token:	JNT
Quoine Liquid:	QASH
Alqo:	ALQO
KingN Coin:	KNC**
Triaconta:	TRIA
Pebbles:	PBL
Magnet:	MAG
Upfiring:	UFR
LociCoin:	LOCI
Lamden Tau:	TAU
Labrys:	LAB
Debitum Token:	DEB
Flixxo:	FLIXX
Farad:	FRD
PayFair:	PFR
Electra:	ECA
Ludum token:	LDM
LiteCoin Gold:	LTG
Bitcoin Diamond:	BCD
StashPay:	STP
SpankChain:	SPANK
MyWish:	WISH
Aerium:	AERM
PlexCoin:	PLX
Autonio:	NIO*
EtherBTC:	ETHB
Commodity Ad Network:	CDX
FoodCoin:	FOOD
Darico:	DEC
Votecoin:	VOT
Uquid Coin:	UQC
EthLend:	LEND
Sether:	SETH
Tio Tour Guides:	TIO*
SHIELD:	XSH
BitCAD:	BCD*
Goldea:	GEA
BridgeCoin:	BCO*
Desire:	DSR
BitDegree:	BDG
SoMee.Social:	ONG
Oyster Pearl:	PRL
BTCMoon:	BTCM
Ethereum Black:	ETBT
ZCashGOLD:	ZCG
Mutual Coin:	MUT
Aion:	AION
Kittehcoin:	MEOW
Divi:	DIVX
Cash & Back Coin:	CNBC
RChain:	RHOC
Arcade City:	ARC*
UltraNote:	XUN
RAFL:	RFL
CoinFi:	COFI
ELTCOIN:	ELTCOIN
Gold Reward Token:	GRX
Neurotoken:	NTK
Eroscoin:	ERO
CyberMiles:	CMT*
Relex:	RLX
People:	MAN
CryptoWave:	CWV
Achain:	ACT*
Neuro:	NRO
Social Send:	SEND
GlobalToken:	GLT
X8Currency:	X8X
BitCoal:	COAL
DaxxCoin:	DAXX
Bulwark:	BWK
FinTab:	FNTB
Monero Gold:	XMRG
EthereumBitcoin:	BTCE
FlypMe:	FYP
BoxyCoin:	BOXY
NagaCoin:	NGC
Universa:	UTN
ETHGAS:	EGAS
Digital Assets Power Play:	DPP
Adbank:	ADB
TargetCoin:	TGT
XinFin Coin:	XDCE
BMChain:	BMT
Biocoin:	BIO
ModulTrade:	MTRC
BTC Lite:	BTCL
PeepCoin:	PCN
PayPro:	PYP
Verify:	CRED
Super Bitcoin:	SBTC
Kalkulus:	KLKS
AC3:	AC3
GIFTO:	GTO
Time New Bank:	TNB
CHIPS:	CHIPS*
Hacken:	HKN
B2BX:	B2B
LockTrip:	LOC*
Media Network Coin:	MNT*
IntenseCoin:	ITNS
SmartMesh:	SMT*
GermanCoin:	GER
LiteCoin Ultra:	LTCU
Bitair:	BTCA
HOQU:	HQX
EthereumFog:	ETF
BitcoinX:	BCX*
Luxmi Coin:	LUX**
Straks:	STAK
BannerCoin:	BCOIN
MediBloc:	MED*
CrowdCoinage:	CCOS
Bounty0x:	BNTY
Bread token:	BRD
Hawala.Exchange:	HAT
aelf:	ELF
Valorem:	VLR
Crypto-X:	CWX
DeepBrain Chain:	DBC
PopularCoin:	POP
CrowdCoin:	CRC***
PhantomX:	PNX
BitAsean:	BAS
United Traders Token:	UTT
HomeBlockCoin:	HBC
MicroMoney:	AMM
DavorCoin:	DAV
Copico:	XCPO
Guaranteed Entrance Token:	GET
Index ERC20:	ERC20
IoT Chain:	ITC
HTML Coin:	HTML
PARKGENE:	GENE
Numus:	NMS
Photon:	PHO
ExtraCredit:	XTRA
Network Token:	NTWK
Sucre:	SUCR
SmartBillions:	SMART*
Genaro Network:	GNX
Nebulas:	NAS
Accolade:	ACCO
Bytether :	BTH
REMME:	REM
TokugawaCoin:	TOK
eREAL:	EREAL
CompuCoin:	CPN
Fantasy Cash:	XFT
QLC Chain:	QLC
BitSerial:	BTSE
OmiseGO Classic:	OMGC
QubitCoin:	Q2C
Bloom Token:	BLT
SportyCo:	SPF
TokenDesk:	TDS
Galactrum:	ORE
Sparks:	SPK
GoaCoin:	GOA
Fuloos Coin:	FLS
Digiwage:	WAGE
GunCoin:	GUN
DFSCoin:	DFS
PolisPay:	POLIS
FireLotto:	FLOT
CoinLancer:	CL
StrongHands:	SHND
ArubaCoin:	AUA
DNN Token:	DNN
SagaCoin:	SAGA
GXChain:	GXS
Energo:	TSL
IrishCoin:	IRL
Bodhi:	BOT
PumaPay:	PMA
Trollcoin:	TROLL
Force Coin:	FOR
Jetcoin:	JET
MediShares:	MDS
Litecoin Plus:	LCP
Game:	GTC
iEthereum:	IETH
TheGCCcoin:	GCC*
Senderon:	SDRN
Ink:	INK
Kubera Coin:	KBR
High Performance Blockchain:	HPB
Monkey Project:	MONK
Jinn:	JINN
Setcoin:	SET
MagnaCoin:	MGN
KZCash:	KZC
Gainer:	GNR
Local World Forwarders:	LWF
BrightCoin:	BRC
World Crypto Gold:	WCG
Hive:	HIVE
GameX:	GX
Luckbox:	LCK
SyncFab:	MFG
EtherLite:	ETL
Telcoin:	TEL
Dragon Coin:	DRG
BinaryCoin:	BRC*
Sp8de:	SPX*
On.Live:	ONL
Zap:	ZAP
AI Doctor:	AIDOC
ECC:	ECC
Eticket4:	ET4
LendConnect:	LCT
EBCoin:	EBC
Vestarin:	VST
Internet Node Token:	INT
COPYTRACK:	CPY
Steneum Coin:	STN
Saifu:	SFU
Pioneer Coin:	PCOIN
Bolenum:	BLN*
Play 2 Live:	LUC
EtherDelta:	EDT
Cyder Coin:	CYDER
Serenity:	SRNT
MultiGames:	MLT
EchoLink:	EKO
UnitedBitcoin:	UBTC
Bottos:	BTO
Doc Coin:	DOC
ArbitrageCT:	ARCT
ImmVRse:	IMV
Aurora:	AURA
IndaHash:	IDH
CommerceBlock Token:	CBT
Interzone:	ITZ
Black Pearl Coin:	XBP
EXRNchain:	EXRN
SingularityNET:	AGI
BF Token:	BFT
Legolas Exchange:	LGO
Crypterium:	CRPT
Sigil:	SGL
Trinity Network Credit:	TNC
Forty Seven Bank:	FSBT
Crafty:	CFTY
Data:	DTA
CarVertical:	CV
DataBroker DAO:	DTX
MediChain:	MCU
Odyssey:	OCN
Theta:	THETA
Measurable Data Token :	MDT*
Purpose:	PRPS
Decentralized Universal Basic Income:	DUBI
Blockport:	BPT
Signals Network:	SGN
IOS token:	IOST
TokenClub :	TCT
OriginTrail:	TRAC
Olympus Labs:	MOT
Zilliqa:	ZIL
Ethorse :	HORSE
QunQun:	QUN
Qbao:	QBT*
Accelerator Network:	ACC*
SwftCoin:	SWFTC
Sentinel:	SENT
InsurePal:	IPL
OP Coin:	OPC
Safinus:	SAF
Shacoin:	SHA
Pylon Network:	PYLNT
Garlicoin:	GRLC
Devery:	EVE
Yee:	YEE
Repux:	REPUX
JoyToken:	JOY
Global Tour Coin:	GTC*
Capdax:	XCD*
BitWhite:	BTW
aXpire:	AXPR
Fortuna:	FOTA
CPChain:	CPC*
Spend:	SPEND
Pundi X:	NPXS
Zeepin:	ZPT
Croat:	CROAT
RefToken:	REF
SPECTRE Dividend Token:	SXDT
SPECTRE Utility Token:	SXUT
LeadCoin:	LDC
FairGame:	FAIR*
Valorbit:	VAL
Matrix AI Network:	MAN*
BlockCDN :	BCDN
STK Token:	STK
Mosaic Network:	MZX
CryCash:	CRC**
SPiCE Venture Capital :	SPICE
Quantum1Net:	Q1S
Polymath Network:	POLY*
Tao:	XTO
Ruff:	RUFF
Elastos:	ELA
TokenPay:	TPAY*
CargoX:	CXO
WeToken:	WT
HashGains:	HGS
Strategic Investments in Significant Areas:	SISA
eBit:	EBIT
RealChain:	RCT
Cool Cousin:	CUZ
Halal-Chain:	HLC
BetterBetting:	BETR
Gimmer:	GMR
Iungo:	ING
LHCoin:	LHC
Bluzelle:	BLZ
Halal:	HALAL
Crave-NG:	CRAVE*
SwissBorg:	CHSB
EQUI Token:	EQUI
1717 Masonic Commemorative Token:	MCT
Crypto Wisdom Coin:	CWIS
My Big Coin:	MBC
Swarm Fund:	SWM
Medicalchain:	MTN*
WorldBTC:	WBTC
Denaro:	DNO
FIC Network:	eFIC
THEKEY Token:	TKY
BANCA:	BANCA
TurtleCoin:	TRTL
BiboxCoin:	BIX
ArcBlock:	ABT*
Helbiz:	HBZ
Care Token:	CARE*
DRP Utility:	DRPU
Dorado:	DOR
Proof Suite Token:	PRFT
Pareto Network Token:	PARETO
Datarius:	DTRC
Intelligence Quotient Benefit:	IQB
NeedleCoin:	NDC*
Bee Token:	BEE
MUNcoin:	MUN
Tigereum:	TIG
Loyakk Vega:	LYK
NYXCOIN:	NYX
DataWallet:	DXT
Satisfaction Token:	SAT
Origami:	ORI
Unified Society USDEX:	USX
Logarithm:	LGR
Bitcoin Atom:	BCA
SegWit2x:	B2X
eXMR Monero:	EXMR
Fusion:	FSN
Useless Eth Token Lite:	UETL
Niobio Cash:	NBR
Block Array:	ARY
Ravelous:	RAVE
Scooby coin:	SCOOBY
Dai:	DAI
CryptopiaFeeShares:	CEFS
Mineable Token:	MINT*
BunnyCoin:	BUN
BitSoar Coin:	BSR
Pirate Blocks:	SKULL
Trident:	TRDT
Bounty:	XBTY
JesusCoin:	JC
Bitcoin Private:	BTCP
Skeincoin:	SKC
RED MegaWatt:	MWAT
Shekel:	JEW
Eristica:	ERT*
Karma:	KRM
Huobi Token:	HT
Bitcoin Candy:	CDY
ShareChain:	SSS
Credence Coin:	CRDNC
BitcoinFile:	BIFI
Content and AD Network:	CAN*
Blockchain Traded Fund:	BTF
IPChain:	IPC*
ShowCoin:	SHOW
StarChain:	STC
Ethfinex Nectar Token:	NEC*
AIChain Token:	AIT
Storiqa Token:	STQ
ALTcoin:	ALT
Travelflex:	TRF
B3Coin:	KB3
fidentiaX:	FDX
KREDS:	KREDS
EQUAL:	EQL
GraphGrail AI:	GAI
Vulcano:	VULC
Creditcoin:	CRE*
DivotyCoin:	DTC**
DADI:	DADI
Maggie Token:	MAG**
Tokyo Coin:	TOKC
UniversalRoyalCoin:	UNRC
BiblePay:	BBP
NITRO:	NOX
Heiss Shares:	HYS
LiteCoinW Plus:	LCWP
NaviAddress:	NAVI
Aditus:	ADI
Tokenomy:	TEN
BitFlux:	FLX*
VV Coin:	VVI
Ankorus Token:	ANK
Purpose Coin:	HLP
VinChain:	VIN
Shping Coin:	SHPING
Petro:	PTR
Bitcoin Royal:	BCR*
Vanywhere:	VANY
TE-FOOD:	TFD
Noxbox:	NBX
BABB:	BAX
Rentberry:	BERRY
SpaceChain:	SPC*
BitFlip:	FLIP
Clinicoin:	CLIN
DeHedge Token:	DHT
Goodomy:	GOOD*
Enkidu:	ENK
ALAX:	ALX
Republic Token:	REN
Dether:	DTH
All Sports Coin:	SOC
Tidex Token:	TDX
LottoCoin:	LOT
Cypherfunks Coin:	FUNK
LeafCoin:	LEAF
Compound Coin:	COMP
BitCar:	BITCAR
Colu Local Network:	CLN
Nihilo Coin:	NIHL
BashCoin:	BASHC
DigiFel:	DIGIF
DigiMoney:	DGM
Cerberus:	CBS
Ternio:	TERN
Savedroid:	SVD
Bitcoin Hush:	BTCH
redBUX:	redBUX
Auctus:	AUC
Lizus Payment:	LIZ
Crypto Improvement Fund:	CIF
Nucleus Vision:	NCASH
Stipend:	SPD
Crowd Machine:	CMCT
Robin8 Profile Utility Token:	PUT*
Fillit:	FILL
Poa Network:	POA
Ravencoin:	RVN
XY Oracle:	XYO
Refereum:	RFR
Props:	PROPS
Fund Platform:	FUND
Celsius Network:	CEL
Credits:	CS*
Pushi:	PUSHI
Bitsense:	BINS
PokerCoin:	POKER
Axys:	AXYS
EvenCoin:	EVN*
Bold:	BOLD
Extensive Coin:	EXTN
Dignity:	DIG
ETH Share:	ETS
LIpcoin:	LIPC
HELL COIN:	HELL
Ellerium:	ELP
Alphacat:	ACAT
Rock Token:	RKT
Eligma:	ELI
CO2 Token:	CO2
Velox:	VLX
Action Coin:	ACTN
Litecoin Cash:	LTCH
Zupply Token:	ZUP
Hamster Marketplace Token:	HMT
Midex:	MDX
Kind Ads:	KIND
Blockchain Terminal:	BCT
Callisto Network:	CLO
Curium:	CRU
Elicoin:	ELI*
Mother Of All Tokens:	MOAT
BelugaPay:	BBI
Bezop:	BEZ
ENTER COIN:	ENTRC
BitcoinGo:	BTCGO
TROPTIONS:	XTROPTIONS
Knowledge :	KNW
Pegascoin:	PGC
BitRewards:	BIT
DATx:	DATX
Plutocoin:	PTC**
Pikciochain:	PKC
StasyQ:	SQOIN
Titanium BAR:	TBAR
Taklimakan:	TKLN
CoinPlace Token:	CPL
BitTube:	TUBE
Cube:	AUTO
Project Shivom:	OMX
Truckcoin:	TRCK
Havven:	HAV
TomoChain:	TOMO
XAYA:	CHI
Invacio:	INV*
W3Coin:	W3C
Dinero:	DIN
Insights Network:	INSTAR
CoinPoker Token:	CHP
Poseidon:	PSD
JET8:	J8T
Lelecoin:	LELE
VEGA:	VEGA*
Akroma:	AKA
ShipChain:	SHIP
I-House Token:	IHT
LocalCoinSwap:	LCS
LaLa World:	LALA
Education Ecosystem:	LEDU
Fox Trading:	FOXT
EasyToken:	ETKN
Robotina:	ROX
Adamant:	ADM
AMBT Token:	AMBT
LevelNet Token:	LVL*
CoinMeet:	MEE
Betrium Token:	BTRM
Manna:	MANNA
Darenta:	PROD
eProxy:	ePRX
Hi Mutual Society:	HMC
ZIX Token:	ZIX
Electrify.Asia:	ELEC
Organic Token:	ORGT
Loom Network:	LOOM
Pantos:	PAN
BotChain:	BOTC
GoChain:	GO
Viewly:	VIEW
Aidos Kuneen:	ADK
Telegram Open Network:	GRAM
Essentia:	ESS
Vice Industry Token:	VIT
Seraph:	SERA
AfterEther:	AET
Cosmo:	CMOS
Pigeoncoin:	PGN
BlockMesh:	BMH
TravelChain:	TT
Reden:	REDN
TulipCoin:	TLP
DAOstack:	GEN*
Bitspace:	BSX
BitcoinEX:	BTCE*
BBNCOIN:	BBN
Lydiancoin:	LDN
Budbo:	BUBO
USOAMIC:	USOAMIC
FluzFluz:	FLUZ
IP Exchange:	IPSX
Miner One token:	MIO
ZeroState:	ZSC*
AI Crypto:	AIC
Mithril:	MITH
Banyan Network:	BBN*
Spindle:	SPD*
Fonero:	FNO
Gostcoin:	GST
Passive Coin:	PAS
Snowgem:	XSG
CavatCoin:	CVTC
FARM Coin:	FARM
Next.exchange Token:	NEXT
BitRent:	RNTB
ClearCoin:	XCLR
BlitzPredict:	XBP*
Debit Coin:	DBC*
Switcheo:	SWTH
Friendz:	FDZ
Voltroon:	VTN
CoinLion:	LION
Market.space:	MASP
Stellite:	XTL
UC Coin:	UCN
Hurify:	HUR
Briacoin:	BRIA
Ignition:	IC
LatiumX:	LATX
ROIcoin:	ROI
Ethereum Premium:	ETHPR
MoneyBag:	MNB
AchieveCoin:	ACH
Bitrolium:	BTL
Goal Bonanza:	GOAL
RAcoin:	RAC
BEX token:	BEX
HOLD:	HOLD
EZToken:	EZT
Sola:	SOL
Victorium:	VIC
CoinMetro:	XCM
Nafen:	NFN
CEEK Smart VR Token:	CEEK
Wiix:	WIIX
eosDAC:	EOSDAC
Bitcoin Interest:	BCI
MedicCoin:	MEDIC
TraDove:	BBC
KWHCoin:	KWH
Cortex:	CTXC
Valid:	VLD
FintruX:	FTX
Globex SCI:	GSI
Bidipass:	BDP
FOLM coin:	FLM
Alpenschillling:	ALPS
Zelcash:	ZEL
Balkancoin:	BKC
Bitcoin Green:	BITG
Deviant Coin:	DEV
Countinghouse Fund:	CHT
GreenX:	GEX
Abjcoin:	ABJ
FutureWorks:	FTW
Rapture:	RAP
Artemine:	ARTE
Animecoin:	ANI
Profit Hunters Coin:	PHC
Ethereum Meta:	ETHM
Ubcoin:	UBC
RoboAdvisorCoin:	RAC*
Sentinel Chain:	SENC
PATRON:	PAT
Ligercoin:	LIGER
NOKU CHF:	CHFN
CryptoLEU:	LEU
Scanetchain Token:	SWC
Avalanche:	AVL
ORS Group:	ORS
Semux:	SEM
Bitdaric:	DARX
BitBlocks:	BBK
RoBET:	RAC**
PolySwarm:	NCT
Uwezocoin:	UWC
U Network:	UUU
Haven Protocol:	XHV
Apex Token:	CPX
Dock.io:	DOCK
Adhive:	ADH
Zilla:	ZLA
Winding Tree:	LIF
The EFFECT Network:	EFX
Lendingblock:	LND
MoneyRebel:	MRP*
FuturoCoin:	FTO
HadePay:	HPAY
Signal:	SIG
Carebit:	CARE
Zealium:	NZL
T-BOT:	TBT
Holo:	HOT*
Acorn Collective:	OAK
Decentralized Machine Learning:	DML
Gems:	GEM
FedoraCoin:	TIPS
MOS Coin:	MOS
Tokenbox:	TBX
Penta:	PNT
WCoin:	WIN
Charm Coin:	CHARM
Proton:	PROTON
Cryptoreal:	CRS
Dero:	DERO
iDealCash:	DEAL
Jumpcoin:	JUMP
Zebi Coin:	ZCO
Kryll:	KRL
NEXO:	NEXO
SwissRealCoin:	SRC**
Sharder:	SS
Infinex:	IFX
0xBitcoin:	0XBTC
EduCoin:	EDU
Peculium:	PCL
Morpheus Infrastructure Token:	MITX
Aphelion:	APH
Nebula AI:	NBAI
CyberVein:	CVT
Tutellus:	TUT
Bettium:	BETT
NOAHCOIN:	NOAH
PolicyPal Network:	PAL
Enumivo:	ENU
Befund:	BFDT
Kepler:	KEP
Rubius:	RUBY
Global Social Chain:	GSC
Desico:	DESI
VLUX:	VLUX
DOCADEMIC:	MTC
MyToken:	MT*
StreamSpace:	SSH
Bitcoin Incognito:	XBI
True Chain:	TRUE
MARK.SPACE:	MRK
Fitrova:	FRV
WinStars:	WINS
Proxeus:	XES
AB-CHAIN:	RTB
FuzeX:	FXT
Hydrogen:	HYDRO
DixiCoin:	DXC
CryptoHub:	CHBR
Owlstand:	OWD
ElliotCoin:	ELLI
AXS:	AXS
AMO Coin:	AMO
Libra Credit:	LBA
Live Stars:	LIVE
Golos Gold:	GBG
Content Neutrality Network:	CNN
Oyster Shell:	SHL
EtherZero:	ETZ
Skrumble Network:	SKM
ShareRing:	SHR
IvyKoin:	IVY
KEYCO:	KEC
ODEM :	ODE
Hydro Protocol:	HOT
Amon:	AMN
SABR Coin:	SABR
HollyWoodCoin:	HWC
bitGold:	BITGOLD
bitSilver:	BITSILVER
GINcoin:	GIN
Open Platform:	OPEN
Nullex:	NLX
Linker Coin:	LNC*
Faceter :	FACE
Morpheus Network:	MRPH
IoTeX Network:	IOTX
AITrading:	AITT
intimate.io:	ITM
VideoCoin:	VID
UCOT:	UCT
Silent Notary:	SNTR
Monero 0:	ZMR
MoneroV:	XMV
NKN:	NKN
Elysian:	ELY
Hero Node:	HER
Parlay:	PAR
Slate:	SLX
Listerclassic Coin:	LTCC
REGA Risk Sharing Token:	RST
Amero:	AMX
The Freedom Coin:	TFC
MaisCoin:	MSC*
Repo Coin:	REPO
IRONCOIN:	IRC
PlatinCoin:	PLC*
Online:	OIO
Angel Token:	ANGL
ANTS Reloaded:	ANTS
BetKings:	KNG
AU-Coin:	AUC*
Commercium :	CMM
Staramba:	STT
Wysker:	WYS
Cognitio:	COG
Zippie:	ZIPT
QuarkChain:	QKC
Optimal Shelf Availability Token:	OSA
Eximchain:	EXC
BitCOEN:	BEN
Endor Protocol Token :	EDR*
Benchmark:	BMK
Rasputin Online Coin:	ROC
Bezant:	BZNT
LoyalCoin:	LYL
Fabric Token:	FT
BitMart Coin:	BMX
PHI Token:	PHI
Paymon:	PMNT
Blocnation:	BNTN
HoryouToken:	HYT
Phantasma:	SOUL*
GreenMed:	GRMD
SelfSell:	SSC
Loki:	LOKI
Blocktrade token:	BTT
Newton Coin:	NCP
Media Protocol Token:	MPT
Staxcoin:	STAX
Mercoin:	MRN
Fopacoin:	FOPA
Universa Token:	UTNP
CashBet Coin:	CBC
Utrum:	OOT
Niobium:	NBC
Swisscoin:	SIC
Algory:	ALG
PCHAIN:	PAI
ExchangeCoin:	EXCC
Reliance:	REL
BitcoiNote:	BTCN
Hero:	HERO
EJA Coin:	EJAC
APIS:	APIS
Sentinel Protocol:	UPP
Xt3ch:	XT3
MassGrid:	MGD
TheVig:	VIG
PluraCoin:	PLURA
Swachhcoin:	SCX
NowCoin:	NWCN
EmaratCoin:	AEC*
BitcoinFor:	BTF*
GMC Coin:	GMC*
Purk:	PURK
Rover Coin:	ROE
Dekado:	DKD
Lynx:	LYNX
Poseidon Quark:	POSQ
OctoBit Coin:	OCTO*
MYCE:	YCE
Original Crypto Coin:	OCC
Arionum:	ARO
BitcoinWSpectrum:	BWS
Bitcoin Core:	BTCC
Muse:	MUSE
OracleChain:	OCT
XcelTrip:	XCEL
EthereCash:	ECH
Motion:	XMN
PlusOneCoin:	PLUS1
Coinnec:	COI
UnicornGo Candy:	CANDY
GambleCoin:	GMCN
Trivecoin:	TRVC
RAVN Korrax :	KRX
BitScreener:	BITX
Sakura Bloom:	SKB*
Hirefreehands:	HFT
OPP Open WiFi:	OPP*
Dystem:	DTEM
Tip Blockchain:	TIP
Inmusik:	SOUND
HeartBout:	HB
Triwer:	TRW
Buglab:	BGL
EPIK Token:	EPIK
ZMINE:	ZMN
Peony Coin:	PNY
SafeCoin:	SAFE
Couchain:	COU
BidCoin:	BID
Atheios:	ATH
Absolute Coin:	ABS
JOYSO:	JOY*
Vitae:	VITAE
Eternal Token:	XET
The 0xDiary Token:	0xDIARY
Bitcoin Supreme:	BTCS*
GenesisX:	XGS
XUEZ:	XUEZ
BitminerCoin:	BIM
DowCoin:	Dow
HexCoin:	HEX
Eminent Token :	EMN
Payther:	PYT
Deimos:	DEI
TPCash:	TPC
Oyster Platform:	OYS
Webchain:	WEB*
JEX Token:	JEX
Ryo:	RYO
MUSDcoin:	MUSD
Mindexcoin:	MIC
Urals Coin:	URALS
Qwertycoin:	QWC
WABnetwork:	WAB
Bitcoin Nova:	BTN
ARENON:	ARE
DACash:	DAC
EUNO:	EUNO
KAASY.AI:	KAAS
MMOCoin:	MMO
Merculet:	MVP
DasCoin:	DASC
Egretia:	EGT
Metronome:	MET*
Puregold token:	PGT
Mediblock:	MEDX
CoinEx token:	CET
TrueGame:	TGAME
Sapien Network:	SPN*
ZINC:	ZINC
Ketan:	KETAN
Karatgold coin:	KBC
Mainframe:	MFT
InsurChain Coin:	INSUR
NIX:	NIX
0chain:	ZCN
Finom FIN Token:	FIN
Render Payment:	RPM
Digix Gold token:	DGX
Italocoin:	ITA
Finom NOM Token:	NOM
Safe Trade Coin:	XSTC
You42:	U42
Engine:	EGCC
Freyrchain:	FREC
Bitswift:	BITS*
Distributed Credit Chain:	DCC*
Aurora :	AOA
LinkEye:	LET
Motion:	MTN**
Project Pai:	PAI*
Mixin:	XIN*
Cybereits Token :	CRE**
CoinMeet:	MEET
Bodhi :	BOE
Rate3 :	RTE
CarBlock :	CAR
Cryptaur:	CPT
Pecunio:	PCO
PokerSports:	XPST
HashCoin :	HSC
MCV Token:	MCV
Scroll:	SCRL
CoinBene:	CONI
Bitnation Pangea:	XPAT
Mont Blanc:	MBLC
DIWtoken:	DIW
Joint Ventures:	JOINT
IDEX Membership:	IDXM
Ccore:	CCO
Atonomi:	ATMI
Tokia:	TKA
SureRemit:	RMT
OneLedger:	OLT
Guaranteed Ethurance Token Extra:	GETX
Everipedia:	IQ
Bittwatt:	BWT
Lendroid Support Token:	LST
Ethereum Movie Venture:	EMV
EtherSportz:	ESZ
TrakInvest:	TRAK
Oxcert:	ZXC
Biotron:	BTRN
XMax:	XMX
VeriME:	VME
VITE:	VITE
OneRoot Network:	RNT
Bigbom:	BBO
Crowdholding:	YUP
SnipCoin:	SNIP
XDNA:	XDNA
SalPay:	SAL
Cardstack:	CARD
LikeCoin:	LIKE
ThriveToken:	THRT
GoToken:	GOT*
Skraps:	SKRP
Animation Vision Cash:	AVH
StockChain Coin:	SCC
Halo Platform:	HALO
BitStation:	BSTN
PITCH:	PITCH
NANJCOIN:	NANJ
PAXEX:	PAXEX
Ditcoin:	DIT
Azart:	AZART
Ordocoin:	RDC
FREE coin:	FREE
Averopay:	AOP
Apollon:	XAP
Influ Token:	INTO
HighCastle Token:	AIMS
ThunderStake:	TSC
SimpleBank:	SPLB
CRYPTOMAGZ:	CMZ
MedicoHealth:	MHP
Homelend:	HMD
Imigize:	IMGZ
NYNJA:	NYN
IAME Identity:	IAM
Urbit Data:	URB
BetOnChart:	CHART
WhenHub:	WHEN
Blockshipping:	CCC*
Cache:	CHE
Zeew:	ZEEW
Memority:	EMT*
Quasa:	QUA
Ronaldinho Soccer Coin:	RSC
ENTRY:	ENTRY
Photochain:	PHT
Aworker:	WORK
Organicco:	ORC
ZAZA:	ZAZA
DeNet:	DNET*
IDAP:	IDAP
Etheal:	HEAL
OfficerCoin:	OFCR
Shipit:	SHPT
PearlPay:	PRLPAY
SKYFchain:	SKYFT
STRYKZ:	STRY
Fan360:	FAN
Unboxed:	NBOX
Buddy:	BUD
Kasko2go:	K2G
GAMB:	GMB
VTUUR:	VTUUR
NextPakk:	Pakka
EtherInc:	ETI
Freldo:	FRECN
NOIA Network:	NOIA
BOOSTO:	BST*
DREAM:	DREAM*
DYNO:	DYNO
MFChain:	MFX
NOIZ:	NOIZ
Spiking:	SPIKE
Selfie GO:	SGO
RAWG:	RAWG
Big Data Block:	BDB
Monoreto:	MNR
YellowBetter:	YBT
ÕpetFoundation:	OPET
Worldopoly:	WPT
Abele:	ABELE
ephelants360:	XEP
ARBITRAGE:	ARB*
TillBilly:	BILL
Scienceroot:	ST
Dataeum:	XDT
Aston:	ATX*
Social Lending Network:	SLT
Apollo Currency:	APL
MyCryptoBank:	MCB
Clipper Coin Capital:	CCCX
Virtual Rehab:	VRH
Aenco:	AEN
VANIG:	VANIG
Tokenaire:	AIRE
WatermelonBlock:	WMB
meVu:	MVU
imusify:	IMU
TuurnT:	TRT
CRYSTALS:	CRS*
Olam:	OLM
Casper API:	CST
YondoCoin:	YON
Universal Recognition Token:	URT
QuickX Protocol:	QCX
Zichain:	ZCN*
TV-TWO:	TTV
Osmium Investment Coin:	OICOIN
Enecuum:	ENQ
Expercoin:	EXPR
Datareum:	DTN
IDM:	IDM
SID Token:	SIDT
Creditor Data Platform:	CDPT
CargoCoin:	CRGO
Cryptics:	QRP
TriipMiles:	TIIM
Virtual Reality Technology:	VRT
Constellation :	DAG
Olive:	OLE
AMLT:	AMLT
HireGo:	HGO
Talenthon:	TCOIN
ProChain:	PRA
Volpo:	VLP
Paygine:	PGC*
Zipper:	ZIP
Bostoken:	BOS*
Kcash:	KCASH
1World:	1WO
BoutsPro:	BOUTS
OriginSport:	ORS*
ESports Chain:	EST
One Game:	OGT
NPER:	NPER
STASIS EURS:	EURS
Xchange:	XCG
BOONSCoin:	BSC*
Omnitude:	ECOM
Witcoin:	WIT
Molecular Future:	MOF
ContentBox:	BOX
COTI:	COTI
Etalon:	ETALON
CargoConX:	TICS
ZPER:	ZPR
Experience Token:	EXT*
EON:	EOT*
ExtraLovers:	ELT*
Blockvest:	BLV
Recycling Regeneration Chain:	RRC
Dominium:	DOM*
Quanta:	QNTU
IG Token :	IG
FormulA:	FML
Irene Energy:	TLU
Prasm:	PSM
Bitkan:	KAN
Namahe:	NMH
StarKST:	KST
DelChain:	DEL
HitChain:	HIT
PayBlock:	PBLK
Sudan Gold Coin:	SGC
Papusha:	PRT
CosmoChain:	COSM
Pluto Project Coin:	GPPT
LunarLink:	LNL
Vernam:	VRN
Bronix:	BRNX
RYFTS:	RFT
ENDO :	ET
Momentum:	MMTM
Golden Hash:	XGH
FXPay:	FXP
Blockpass:	PASS
Digitex Futures:	DGTX
BitSchool:	BSCH
Credible:	PESA
Galion Token:	GLN
No BS Crypto:	NOBS
CoinPulseToken:	CPEX
Ethereum Classic:	ETC
MilionCoin:	MON
Vertcoin:	VTC
Monero Classic:	XMC
Monero Original:	XMO
Hdac:	HDAC
Insureum:	ISR
Talent Token:	TLNT
RoBust Defense Token:	RBDT
Paytomat:	PTI
Raiden Network:	RDN*
NOKU EUR:	EURN
NOKU Master token:	NOKU
EOS:	EOS
Poseidon Chain:	PCCM
MyriadCoin:	XMY
BrickBlock:	BBK*
Topchain:	TOPC
LitecoinCash:	LCC
BitSend:	BSD
Plancoin:	PLAN
Mobile Integrated Blockchain:	MIB
PutinCoin:	PUT
BaaSid:	BAAS
Delphy:	DPY
Bountie:	BNTE
Tripio:	TRIO
EverLife.AI:	EVER
Chynge.net:	CLPX
ZNAQ:	ZNAQ
Neonexchange :	NEX
SRCoin:	SRCOIN
V-ID:	VIDT
Trivver:	TRVR
Giant:	GIC
Trecento Blockchain Capital:	TOT*
Stakenet:	XSN
X2Coin:	X2
POPCHAIN:	PCH
Digital Gold Exchange:	TMTG
DICE Money:	CET*
MODEX Token:	MODEX
Gemini Dollar:	GUSD
GolfCoin:	GOLF
PlayChip:	PLA
HEROIC.com:	HRO
Blockchain Index:	BLX
Green Energy Token:	WPP
Acute Angle Cloud:	AAC
Zen Protocol:	ZP
Well:	WELL
Teachers Blockchain:	TCH
SmartLands:	SLT*
OpenChat:	CHAT
Aurora Coin:	AUR
MobileGo:	MGO
Curaizon:	CTKN
Zero Carbon Project:	NRG
Spotcoin:	SPOT
Traid:	TRAID
CEDEX Coin:	CEDEX
Lympo:	LYM
ILCoin:	ILC
Opu Coin:	OPU
Productivist:	PROD*
RedCab:	REDC
MADANA:	PAX
Daox:	DXC*
Little Phil:	LPC
LAPO:	LAX
Hanacoin:	HANA
Cryptelo Coin:	CRL
Invox Finance:	INVOX
Mint:	MNTS
CashBagCoin:	CBC*
iOlite:	ILT
ZayedCoin:	ZYD
UTEMIS:	UTS
Gron Digital:	GRO
The Abyss:	ABYSS
Minereum:	MNE
Yumerium:	YUM
AdEx:	ADX
Royal Kingdom Coin:	RKC
Crypto.com:	MCO
Ethos:	ETHOS
OKOIN:	OKOIN
TrueDeck:	TDP
Cryptonetix:	CIX
MovieCoin:	MOV
UniBright:	UBT
Etherisc:	DIP
MobileBridge Momentum:	CHF*
Verasity:	VRA
Dropil:	DROP
Coinvest:	COIN
EncryptoTel:	ETT
Traxia Membership Token:	TMT**
HyperLending:	HLD
CyClean:	CCL
HYCON:	HYC
Decentralized Accessible Content Chain :	DACC
ICST:	ICST
Beauty Chain:	BEC
LIVEEN:	VEEN
MIO DIO COIN:	MIO DIO
Cannabium:	CNAB
SGPay:	SGP
Lightpaycoin:	LPC*
Bitvote:	BTV
Shine Chain:	SHE
Crystal Clear Token :	CCT
Arena:	ARENA
Sugar Exchange:	SGR
Authoreon:	AUN
Daneel:	DAN
CoTrader:	COT
Healthureum:	HHEM
Ink Protocol:	XNK
Scry.info:	DDD
Bit-Z:	BZ
PROVER:	PROOF
Streamity:	STM
Bob's Repair:	BOB
BitStone:	BST
Kvantor:	KVT*
DAV:	DAV*
Invictus Hyperion Fund:	IHF
Inlock:	ILK
8 Circuit Studios:	8BT
Ontology:	ONT
Bitcoin:	BTC
MoneyToken:	IMT
Blockonix:	BDT
Bettex coin:	BTXC
Kryptoin:	KRP
ECOMI:	OMI
CrypticCoin:	CRYP
DAPS Token:	DAPS
RoBet:	ROBET
Ubex:	UBEX
World Bit Bank:	WBBC
Pool of Stake:	PSK
GigTricks:	GBTC
Aussie Digital:	AUD
Aukcecoin:	AUK
Universal Reward Protocol:	URP
IVN Security:	IVN
USDC:	USDC
Nano Healthcare Token:	NHCT
Tradelize:	TDZ
STEX:	STEX
Horizen:	ZEN
SportsFix:	SFT
T-Coin:	TCX
Terawatt:	LED
ARROUND:	ARR
Eternal Trusts:	ETT*
Goldchip Mining Asset:	GMA
WAR FIELD:	GLDR
Datablockchain:	DBCCOIN
Kinesis Velocity Token :	KVT
Solidified:	SOLID
Pallium:	PLMT
INTRO:	ITR
JSEcoin:	JSE
PeruCoin:	PERU
Further Network:	ATON
TrustedCars FLEX:	FLEX
Ternion:	TRN
AgentMile:	ESTATE
LaneAxis:	AXIS
FlipNpik:	FNP
Cryptocean:	CRON
Orbis:	ORBS
True USD:	TUSD
STARS :	STRS
Pavocoin:	PAVO
USCoin:	USCOIN
TRON:	TRX
DigitalNote :	XDN
Blockchain.io:	BCIO
Lynked.World:	LYNK
Trippki:	TRIP
Azbit:	AZ